  a b c d e f g h i j k l m n o p q r s t u v w x y z ( ) + / * - 1 2 3 4 5 6 7 8 9 0
a 0 2 1 3 2 1 2 2 1 1 1 1 1 2 2 2 2 1 1 1 1 1 1 1 1 1 1 1 1 1 2 1 1 1 1 1 1 2 1 1 2 2
b 2 0 1 2 2 1 2 3 1 1 2 1 1 2 2 2 2 1 1 1 1 1 1 1 1 1 1 1 1 1 1 1 1 1 1 1 2 2 1 1 2 2
c 1 1 0 1 3 1 1 1 1 1 2 1 1 1 2 1 1 2 1 1 1 1 1 1 1 1 1 1 1 1 1 1 1 1 1 1 1 1 1 1 1 2
d 3 2 1 0 1 1 2 1 1 1 1 1 1 1 2 1 2 1 1 1 1 1 1 1 1 1 1 1 1 1 2 1 1 1 1 1 2 2 1 2 2 2
e 2 2 3 1 0 1 2 1 1 1 1 1 1 1 2 2 2 2 1 1 1 1 1 1 1 1 1 1 1 1 1 1 1 1 1 1 1 2 1 1 2 1
f 1 1 1 1 1 0 1 1 3 3 1 2 1 1 1 1 1 2 1 3 1 1 1 1 2 2 2 2 1 2 1 1 2 1 1 1 1 1 2 1 1 1
g 2 2 1 2 2 1 0 1 1 1 1 1 1 1 2 2 3 1 1 1 1 1 1 1 2 1 1 1 1 1 1 1 1 1 1 2 1 2 1 1 3 2
h 2 3 1 1 1 1 1 0 2 1 2 1 1 1 1 1 1 1 1 1 1 1 1 2 1 1 1 1 1 1 1 1 1 1 1 2 1 1 1 1 1 1
i 1 1 1 1 1 2 1 1 0 3 1 3 1 1 1 1 1 1 1 1 1 1 1 1 1 1 2 2 1 2 1 1 3 1 1 1 1 1 1 1 1 1
j 1 1 1 1 1 3 1 1 3 0 1 2 1 1 1 1 1 1 1 2 1 1 1 1 1 1 2 2 1 2 1 1 2 1 1 1 1 1 1 1 1 1
k 1 2 2 1 1 1 1 2 1 1 0 1 1 1 1 1 1 1 1 2 1 1 1 2 1 1 1 1 1 1 1 1 1 1 1 2 1 1 1 1 1 1
l 1 1 1 1 1 2 1 1 3 2 1 0 1 1 1 1 1 2 1 2 1 1 1 1 1 1 3 3 1 3 1 1 2 1 1 1 1 1 1 1 1 1
m 1 1 1 1 1 1 1 1 1 1 1 1 0 3 1 1 1 1 1 1 1 1 2 1 1 1 1 1 1 1 1 1 1 1 1 1 1 1 1 1 1 1
n 2 2 1 1 1 1 1 1 1 1 1 1 3 0 2 1 1 2 1 1 2 2 2 1 1 1 1 1 1 1 1 1 1 1 1 1 1 1 1 1 1 1
o 2 2 2 2 2 1 2 1 1 1 1 1 1 2 0 2 2 1 1 1 2 1 1 1 1 1 1 1 1 1 1 1 1 1 1 1 1 2 1 1 1 3
p 2 2 1 1 2 1 2 1 1 1 1 1 1 1 2 0 2 1 1 1 1 1 1 1 1 1 1 1 1 1 1 1 1 1 1 1 1 1 1 1 2 2
q 2 2 1 2 2 1 3 1 1 1 1 1 1 1 2 2 0 1 1 1 1 1 1 1 2 1 1 1 1 1 1 1 1 1 1 1 1 1 1 1 3 2
r 1 1 2 1 2 2 1 1 1 1 1 2 1 2 1 1 1 0 1 1 1 1 1 2 1 1 1 1 1 2 1 1 1 1 1 1 1 1 1 1 1 1
s 1 1 1 1 1 1 1 1 1 1 1 1 1 1 1 1 1 1 0 2 1 1 1 1 1 2 1 1 1 1 1 1 1 2 1 1 3 1 1 1 1 1
t 1 1 1 1 1 3 1 1 1 2 2 2 1 1 1 1 1 1 2 0 1 1 1 1 1 1 2 1 3 1 1 1 1 1 1 1 1 1 1 1 1 1
u 1 1 1 1 1 1 1 1 1 1 1 1 1 2 2 1 1 1 1 1 0 3 2 1 2 1 1 1 1 1 1 1 1 1 1 1 1 1 1 1 1 1
v 1 1 1 1 1 1 1 1 1 1 1 1 1 2 1 1 1 1 1 1 3 0 3 1 3 1 1 1 1 1 1 1 1 1 1 1 1 1 1 1 1 1
w 1 1 1 1 1 2 2 1 1 1 1 1 1 1 1 1 2 1 1 1 2 3 0 1 2 1 1 1 1 1 1 1 1 1 1 1 1 1 1 1 1 1
x 1 1 1 1 1 1 1 2 1 1 2 1 1 1 1 1 1 2 1 1 1 1 1 0 2 1 1 1 2 1 1 1 1 1 1 1 1 1 1 1 1 1
y 1 1 1 1 1 2 2 1 1 1 1 1 1 1 1 1 2 1 1 1 2 3 2 2 0 1 1 1 1 1 1 1 1 1 1 2 1 1 1 1 1 1
z 1 1 1 1 1 2 1 1 1 1 1 1 1 1 1 1 1 1 2 1 1 1 1 1 1 0 1 1 1 1 1 1 1 3 1 1 1 1 1 1 1 1
( 1 1 1 1 1 2 1 1 2 2 1 3 1 1 1 1 1 1 1 2 1 1 1 1 1 1 0 3 1 3 1 1 2 1 1 1 1 1 1 1 1 1
) 1 1 1 1 1 2 1 1 2 2 1 3 1 1 1 1 1 1 1 1 1 1 1 1 1 1 3 0 1 2 1 1 3 1 1 1 1 1 2 1 1 1
+ 1 1 1 1 1 1 1 1 1 1 1 1 1 1 1 1 1 1 1 3 1 1 1 2 1 1 1 1 0 1 2 1 1 1 1 2 1 1 1 1 1 1
/ 1 1 1 1 1 2 1 1 2 2 1 3 1 1 1 1 1 2 1 1 1 1 1 1 1 1 3 2 1 0 1 1 2 1 1 1 1 1 2 1 1 1
* 2 1 1 2 1 1 1 1 1 1 1 1 1 1 1 1 1 1 1 1 1 1 1 1 1 1 1 1 2 1 0 3 1 1 1 1 1 1 1 1 1 1
- 1 1 1 1 1 1 1 1 1 1 1 1 1 1 1 1 1 1 1 1 1 1 1 1 1 1 1 1 1 1 3 0 1 1 1 1 1 1 1 1 1 1
1 1 1 1 1 1 2 1 1 3 2 1 2 1 1 1 1 1 1 1 1 1 1 1 1 1 1 2 3 1 2 1 1 0 2 1 1 1 1 3 1 1 1
2 1 1 1 1 1 1 1 1 1 1 1 1 1 1 1 1 1 1 2 1 1 1 1 1 1 3 1 1 1 1 1 1 2 0 2 1 2 1 2 1 1 1
3 1 1 1 1 1 1 1 1 1 1 1 1 1 1 1 1 1 1 1 1 1 1 1 1 1 1 1 1 1 1 1 1 1 2 0 1 1 1 1 1 1 1
4 1 1 1 1 1 1 2 2 1 1 2 1 1 1 1 1 1 1 1 1 1 1 1 1 2 1 1 1 2 1 1 1 1 1 1 0 1 1 1 1 1 1
5 1 2 1 2 1 1 1 1 1 1 1 1 1 1 1 1 1 1 3 1 1 1 1 1 1 1 1 1 1 1 1 1 1 2 1 1 0 1 1 1 1 1
6 2 2 1 2 2 1 2 1 1 1 1 1 1 1 2 1 1 1 1 1 1 1 1 1 1 1 1 1 1 1 1 1 1 1 1 1 1 0 1 1 2 1
7 1 1 1 1 1 2 1 1 1 1 1 1 1 1 1 1 1 1 1 1 1 1 1 1 1 1 1 2 1 2 1 1 3 2 1 1 1 1 0 1 1 1
8 1 1 1 2 1 1 1 1 1 1 1 1 1 1 1 1 1 1 1 1 1 1 1 1 1 1 1 1 1 1 1 1 1 1 1 1 1 1 1 0 2 2
9 2 2 1 2 2 1 3 1 1 1 1 1 1 1 1 2 3 1 1 1 1 1 1 1 1 1 1 1 1 1 1 1 1 1 1 1 1 2 1 2 0 2
0 2 2 2 2 1 1 2 1 1 1 1 1 1 1 3 2 2 1 1 1 1 1 1 1 1 1 1 1 1 1 1 1 1 1 1 1 1 1 1 2 2 0